team,rank,PTS,MP,W,L,D,GF,GA,GD
SD,1,33,20,10,7,3,29,22,7
POR,2,32,20,9,6,5,40,27,13
NJNY,3,30,20,8,6,6,23,21,2
NC,4,29,20,8,7,5,28,22,6
WAS,5,29,20,7,5,8,26,28,-2
RGN,6,28,20,8,8,4,26,24,2
ORL,7,28,20,9,10,1,24,25,-1
HOU,8,26,20,6,6,8,15,15,0
LA,9,25,20,6,7,7,24,28,-4
LOU,10,24,20,5,6,9,22,20,2
CHI,11,24,20,7,10,3,25,41,-16
KCC,12,22,20,7,12,1,22,31,-9
