p1,p2,combos,p1g,p1a,p2g,p2a,p1g_p2a,p2g_p1a,goals
Sophia Smith,Morgan Weaver,3,11,5,7,4,2,1,18
Lynn Williams,Midge Purce,3,7,2,4,2,2,1,11
Jaedyn Shaw,Makenzy Doniak,3,6,3,3,2,1,2,9
Megan Rapinoe,Veronica Latsko,3,4,5,4,2,0,3,8
Savannah McCaskill,Katie Johnson,3,4,3,3,1,1,2,7
Sophia Smith,Hina Sugita,2,11,5,6,3,2,0,17
Sophia Smith,Crystal Dunn,2,11,5,5,2,0,2,16
Sophia Smith,Christine Sinclair,2,11,5,3,1,1,1,14
Ashley Hatch,Trinity Rodman,2,9,2,5,2,1,1,14
Alex Morgan,Jaedyn Shaw,2,7,5,6,3,0,2,13
Kerolin,Tess Boade,2,10,0,1,2,2,0,11
Savannah DeMelo,Kirsten Davis,2,5,2,4,1,0,2,9
Alex Morgan,Madison Pogarch,2,7,5,1,1,1,1,8
Messiah Bright,Julie Doyle,2,6,0,2,3,2,0,8
Adriana Leal da Silva,Mikayla Cluff,2,6,4,2,1,0,2,8
Morgan Weaver,Sam Coffey,2,7,4,0,8,2,0,7
Adriana Leal da Silva,Ally Watt,2,6,4,1,1,1,1,7
Alyssa Thompson,Jun Endo,2,4,2,3,2,1,1,7
Kirsten Davis,Thembi Kgatlana,2,4,1,2,1,1,1,6
Claire Emslie,Jun Endo,2,3,5,3,2,1,1,6
Maria Sánchez,Ebony Salmon,2,4,0,1,2,2,0,5
Diana Ordóñez,María Sánchez,2,3,0,0,4,2,0,3
Abby Erceg,Shuang Wang,2,2,0,0,2,2,0,2
Debinha,Cece Kizer,1,9,0,6,2,1,0,15
Ashley Hatch,Ashley Sanchez,1,9,2,5,1,1,0,14
Sophia Smith,Natalia Kuikka,1,11,5,2,2,1,0,13
Morgan Weaver,Hina Sugita,1,7,4,6,3,0,1,13
Sophia Smith,Michele Vasconcelos,1,11,5,1,0,0,1,12
Ashley Hatch,Paige Metayer,1,9,2,3,1,0,1,12
Sophia Smith,Sam Coffey,1,11,5,0,8,1,0,11
Sophia Smith,Meghan Klingenberg,1,11,5,0,3,1,0,11
Kerolin,Narumi Miura,1,10,0,1,3,1,0,11
Kerolin,Haley Hopkins,1,10,0,1,1,1,0,11
Kerolin,Kaleigh Kurtz,1,10,0,1,1,1,0,11
Debinha,Mimmi Larsson,1,9,0,2,2,1,0,11
Hina Sugita,Crystal Dunn,1,6,3,5,2,0,1,11
Kerolin,Mille Gejl,1,10,0,0,1,1,0,10
Kerolin,Ryan Williams,1,10,0,0,2,1,0,10
Morgan Weaver,Christine Sinclair,1,7,4,3,1,0,1,10
Alex Morgan,Makenzy Doniak,1,7,5,3,2,0,1,10
Bethany Balcer,Jessica Fishlock,1,6,1,4,0,0,1,10
Bethany Balcer,Megan Rapinoe,1,6,1,4,5,1,0,10
Bethany Balcer,Veronica Latsko,1,6,1,4,2,1,0,10
Trinity Rodman,Ashley Sanchez,1,5,2,5,1,0,1,10
Debinha,Alex Loera,1,9,0,0,4,1,0,9
Debinha,Hailie Mace,1,9,0,0,2,1,0,9
Debinha,Lo'eau LaBonta,1,9,0,0,1,1,0,9
Debinha,Vanessa DiBernardo,1,9,0,0,2,1,0,9
Lynn Williams,Esther González Rodríguez,1,7,2,2,0,0,1,9
Morgan Weaver,Olivia Moultrie,1,7,4,2,3,1,0,9
Cece Kizer,Isabel Rodriguez,1,6,2,3,0,0,1,9
Cece Kizer,Michelle Cooper,1,6,2,3,1,1,0,9
Jordyn Huitema,Veronica Latsko,1,5,0,4,2,1,0,9
Lynn Williams,Yazmeen Ryan,1,7,2,1,1,1,0,8
Alex Morgan,Kristen McNabb,1,7,5,1,0,0,1,8
Adriana Leal da Silva,Julie Doyle,1,6,4,2,3,1,0,8
Jaedyn Shaw,Kyra Taylor Carusa,1,6,3,2,0,0,1,8
Ashley Sanchez,Paige Metayer,1,5,1,3,1,1,0,8
Crystal Dunn,Christine Sinclair,1,5,2,3,1,0,1,8
Michelle Alozie,Maria Sánchez,1,4,1,4,0,0,1,8
Savannah McCaskill,Alyssa Thompson,1,4,3,4,2,0,1,8
Lynn Williams,Nealy Martin,1,7,2,0,1,1,0,7
Lynn Williams,Sinead Farrelly,1,7,2,0,1,1,0,7
Alex Morgan,Christen Westphal,1,7,5,0,4,1,0,7
Alex Morgan,Danielle Colaprico,1,7,5,0,1,1,0,7
Messiah Bright,Kylie Strom,1,6,0,1,1,1,0,7
Tyler Lussi,Manaka Matsukubo,1,6,0,1,1,1,0,7
Tyler Lussi,Rikke Madsen,1,6,0,1,1,1,0,7
Bethany Balcer,Quinn,1,6,1,1,2,1,0,7
Bethany Balcer,Sofia Huerta,1,6,1,1,2,1,0,7
Adriana Leal da Silva,Rafaelle Leone Carvalho de Souza,1,6,4,1,0,0,1,7
Jordyn Huitema,Elyse Bennett,1,5,0,2,2,1,0,7
Crystal Dunn,Olivia Moultrie,1,5,2,2,3,0,1,7
Bianca St-Georges,Penelope Elizabeth Hocking,1,4,1,3,0,0,1,7
Alyssa Thompson,Claire Emslie,1,4,2,3,5,1,0,7
Ella Stevens,Penelope Elizabeth Hocking,1,4,1,3,0,0,1,7
Messiah Bright,Marta Vieira da Silva Veiga,1,6,0,0,4,1,0,6
Messiah Bright,Erika Tymrak,1,6,0,0,3,1,0,6
Tyler Lussi,Emily Fox,1,6,0,0,2,1,0,6
Tyler Lussi,Kiki Pickett,1,6,0,0,1,1,0,6
Bethany Balcer,Lauren Barnes,1,6,1,0,1,1,0,6
Cece Kizer,Alex Loera,1,6,2,0,4,1,0,6
Cece Kizer,Hailie Mace,1,6,2,0,2,1,0,6
Cece Kizer,Izzy Rodriguez,1,6,2,0,2,1,0,6
Adriana Leal da Silva,Erika Tymrak,1,6,4,0,3,1,0,6
Adriana Leal da Silva,Marta Vieira da Silva Veiga,1,6,4,0,4,1,0,6
Cece Kizer,Vanessa DiBernardo,1,6,2,0,2,1,0,6
Hina Sugita,Sam Coffey,1,6,3,0,8,1,0,6
Jaedyn Shaw,Christen Westphal,1,6,3,0,4,1,0,6
Ashley Sanchez,Ouleymata Sarr,1,5,1,1,1,1,0,6
Jordyn Huitema,Sofia Huerta,1,5,0,1,2,1,0,6
Megan Rapinoe,Elyse Bennett,1,4,5,2,2,0,1,6
Veronica Latsko,Elyse Bennett,1,4,2,2,2,1,0,6
Alyssa Thompson,Sydney Leroux,1,4,2,2,1,0,1,6
Claire Emslie,Katie Johnson,1,3,5,3,1,0,1,6
Claire Emslie,Mary Alice Vignola,1,3,5,3,0,0,1,6
Trinity Rodman,Dorian Bailey,1,5,2,0,2,1,0,5
Trinity Rodman,Gabrielle Carle,1,5,2,0,1,1,0,5
Jordyn Huitema,Alana Cook,1,5,0,0,2,1,0,5
Crystal Dunn,Meghan Klingenberg,1,5,2,0,3,1,0,5
Crystal Dunn,Sam Coffey,1,5,2,0,8,1,0,5
Megan Rapinoe,Quinn,1,4,5,1,2,1,0,5
Savannah McCaskill,Scarlett Camberos,1,4,3,1,3,1,0,5
Ella Stevens,Tatumn Milazzo,1,4,1,1,1,1,0,5
Makenzy Doniak,Kyra Taylor Carusa,1,3,2,2,0,0,1,5
Mary Alice Vignola,Sydney Leroux,1,3,0,2,1,1,0,5
Isabel Rodriguez,Mimmi Larsson,1,3,0,2,2,1,0,5
Midge Purce,Delanie Sheehan,1,4,2,0,2,1,0,4
Michelle Alozie,Nichelle Prince,1,4,1,0,2,1,0,4
Michelle Alozie,María Sánchez,1,4,1,0,4,1,0,4
Kirsten Davis,Madalyn Pokorny,1,4,1,0,1,1,0,4
Megan Rapinoe,Jess Fishlock,1,4,5,0,1,1,0,4
Yuki Ogimi Nagasato,Casey Krueger,1,4,0,0,2,1,0,4
Savannah McCaskill,M. A. Vignola,1,4,3,0,1,1,0,4
Bianca St-Georges,Ally Schlegel,1,4,1,0,1,1,0,4
Bianca St-Georges,Casey Krueger,1,4,1,0,2,1,0,4
Bianca St-Georges,Julia Bianchi,1,4,1,0,5,1,0,4
Alyssa Thompson,Dani Weatherholt,1,4,2,0,1,1,0,4
Jenna Nighswonger,Kristie Mewis,1,4,0,0,1,1,0,4
Jessica Fishlock,Alana Cook,1,4,0,0,2,1,0,4
Jessica Fishlock,Emily Sonnett,1,4,0,0,1,1,0,4
Jessica Fishlock,Rose Lavelle,1,4,0,0,1,1,0,4
Ella Stevens,Julia Bianchi,1,4,1,0,5,1,0,4
Yuki Ogimi Nagasato,Penelope Hocking,1,4,0,0,1,1,0,4
Mary Alice Vignola,Scarlett Camberos,1,3,0,1,3,1,0,4
Penelope Elizabeth Hocking,Cheyna Matthews,1,3,0,1,1,1,0,4
Paige Metayer,Sam Staab,1,3,1,1,1,1,0,4
Jun Endo,Madison Hammond,1,3,2,1,1,1,0,4
Claire Emslie,Scarlett Camberos,1,3,5,1,3,0,1,4
Olivia Moultrie,Hannah Betfort,1,2,3,2,0,0,1,4
Olivia Moultrie,Natalia Kuikka,1,2,3,2,2,1,0,4
Sofia Jakobsson,Sierra Enge,1,2,1,2,0,0,1,4
Alexa Spaanstra,Lo’eau LaBonta,1,2,1,2,0,0,1,4
Paige Metayer,Lena Silano,1,3,1,0,1,1,0,3
Paige Monaghan,Kayla Fischer,1,3,0,0,1,1,0,3
Ava Cook,Yuki Nagasato,1,3,0,0,2,1,0,3
Ava Cook,Julia Bianchi,1,3,0,0,5,1,0,3
Isabel Rodriguez,Débora Cristiane de Oliveira,1,3,0,0,2,1,0,3
Mikayla Cluff,Mariana Larroquette,1,2,1,1,0,0,1,3
Mille Gejl Jensen,Narumi Miura,1,2,0,1,3,1,0,3
Tara McKeown,Ouleymata Sarr,1,2,1,1,1,0,1,3
Olivia Moultrie,Rocky Rodriguez,1,2,3,1,0,0,1,3
Bruninha,Taylor Smith,1,2,0,1,1,1,0,3
Mille Gejl Jensen,Denise O'Sullivan,1,2,0,0,1,1,0,2
Mimmi Larsson,Alex Loera,1,2,2,0,4,1,0,2
Kristen Hamilton,Débora Cristiane de Oliveira,1,2,0,0,2,1,0,2
Kristen Hamilton,Kate Del Fava,1,2,0,0,1,1,0,2
Tara McKeown,Dorian Bailey,1,2,1,0,2,1,0,2
Thembi Kgatlana,Rebecca Holloway,1,2,1,0,1,1,0,2
Natalia Kuikka,Sam Coffey,1,2,2,0,8,1,0,2
Sofia Jakobsson,Christen Westphal,1,2,1,0,4,1,0,2
Julie Doyle,Erika Tymrak,1,2,3,0,3,1,0,2
Alexa Spaanstra,Alex Loera,1,2,1,0,4,1,0,2
Alexa Spaanstra,Izzy Rodriguez,1,2,1,0,2,1,0,2
Allison Schlegel,Julia Bianchi,1,2,0,0,5,1,0,2
Amirah Ali,Melanie Barcenas,1,2,0,0,1,1,0,2
Haley McCutcheon,Viviana Villacorta,1,2,0,0,1,1,0,2
Hannah Betfort,Meghan Klingenberg,1,2,0,0,3,1,0,2
Katie Stengel,Ifeoma Onumonu,1,2,0,0,1,1,0,2
Elyse Bennett,Nikki Stanton,1,2,2,0,2,1,0,2
Narumi Miura,Denise Rebecca O'Sullivan,1,1,3,1,0,0,1,2
Clarisse Le Bihan,Jasmyne Spencer,1,1,4,1,0,0,1,2
Clarisse Le Bihan,Julie Ertz,1,1,4,1,0,0,1,2
Clarisse Le Bihan,Madison Hammond,1,1,4,1,1,0,1,2
Clarisse Le Bihan,Paige Nielsen,1,1,4,1,0,0,1,2
Clarisse Le Bihan,Scarlett Camberos,1,1,4,1,3,1,0,2
Meredith Speck,Olivia Wingate,1,1,0,0,2,1,0,1
Manaka Matsukubo,Emily Fox,1,1,1,0,2,1,0,1
Kylie Strom,Marta Vieira da Silva Veiga,1,1,1,0,4,1,0,1
Kerry Abello,Marta Vieira da Silva Veiga,1,1,0,0,4,1,0,1
Tatumn Milazzo,Julia Bianchi,1,1,1,0,5,1,0,1
Taylor Kornieck,Kelsey Turnbow,1,1,0,0,1,1,0,1
Taylor Smith,Delanie Sheehan,1,1,1,0,2,1,0,1
Tess Boade,Kerolin Nicoli Israel Ferraz,1,1,2,0,3,1,0,1
Victoria Pickett,Olivia Wingate,1,1,0,0,2,1,0,1
Yazmeen Ryan,Kristen Edmonds,1,1,1,0,1,1,0,1
Narumi Miura,Kerolin Nicoli Israel Ferraz,1,1,3,0,3,1,0,1
Quinn,Nikki Stanton,1,1,2,0,2,1,0,1
Reyna Reyes,Sam Coffey,1,1,0,0,8,1,0,1
Rikke Madsen,Ryan Williams,1,1,1,0,2,1,0,1
Sam Staab,Inès Jaurena,1,1,1,0,1,1,0,1
Kelli Hubly,Sam Coffey,1,1,0,0,8,1,0,1
Belle Briede,Christen Westphal,1,1,0,0,4,1,0,1
Brianna Pinto,Frankie Tagliaferri,1,1,0,0,1,1,0,1
Cari Roccaro,Sarah Griffith,1,1,0,0,1,1,0,1
Kayla Lynne Sharples,Yuki Nagasato,1,1,0,0,2,1,0,1
Ally Prisock,Caprice Dydasco,1,1,0,0,1,1,0,1
Andressa,Nichelle Prince,1,1,0,0,2,1,0,1
Jordan Elisabeth Baggett,Lauren Milliet,1,1,0,0,1,1,0,1
Haley Hopkins,Kerolin Nicoli Israel Ferraz,1,1,1,0,3,1,0,1
Ebony Salmon,María Sánchez,1,1,2,0,4,1,0,1
